1111111111
0000000000
0000F00000
000000000000000
00000F0000
0000111110
00000P0000
0000000000
0000000000
1111111111